XXXXXXX
X0m0m0X
X00m00X
X00m00X
X0m0m0X
XXXXXXX