X0XXXXXX0X
0000000000
X00000000X
X00000000X
X00000000X
X00000000X
X00000000X
0000000000
X0XXXXXX0X